11111111111
1P00C0C0EC1
11111111111